11111111111111111111
10000000000000000001
10FFFFFFFFFFFFFFFF01
10FCF1C000000C00FFF1
10F00F01111010000GE1
10FP0000C00C1000FFF1
10FFFFFFFFFFFFFFFF01
10000000000000000001
11111111111111111111