11111111111111111111
10000000000000000001
10FFFFFFFFFFFFFFFF01
10FCF1C000000C0CFF01
10F00F0111101000GF01
10FP0000E00C100CFF01
10FFFFFFFFFFFFFFFF01
10000000000000000001
11111111111111111111