11111111111111111111111111111111111111
1000000000000000000001000000000C000001
10FFFFFFFFFFFFFFFF0001000C000000000001
10FCF1C000000C00FFFFFF000000C000000001
10F00F01111010000G000000F00C0000000001
10FP0000C00C1000FFFFFF000000F000000001
10FFFFFFFFFFFFFFFF00010000C00000000FF1
1000000000000000000001000000000C000GE1
11111111111111111111111111111111111111