111111111111111111111111111111111111111
1000000000000000000000000000000000G0001
100000000000000000000000000000000000001
10000000000FFFF0000FFFFFFF0000000000001
1000000000F00000000000000F0000000000001
100000000FEG0000000000000F0000000000001
10000000F0000000000FFFFFFF0000000000001
10000000FFFFFFF0000F0000000000000000001
10000000000000F0000F0000000000000000001
10000000000000F0000FFFFFFF0000000000001
1000000000000000000000000000000000G0001
10000P000000000C0C00C000C00000000000001
100000000000000000000000000000000000001
100000000000000000000000C00000000000001
100000000000000000000000000000000000001
100000000000C0000000000000C000000000001
111111111111111111111111111111111111111