1111111111111111111111111111111111111111
1000000000000000000000000000000000000001
10FFFFFFFFFFFFFFFF0000000000000000000001
10FCF1C000000C0CFF0000000000000000000001
10F00F0111101000GF0000000000000000000001
10FP0000E00C100CFF0000000000000000000001
10FFFFFFFF0FFFFFFF0000000000000000000001
1000000000000000000000000000000000000001
1000000000000000000000000000000000000001
1000000000000000000000000000000000000001
1000000000000000000000000000000000000001
1000000000000000000000000000000000000001
1000000000000000000000000000000000000001
1000000000000000000000000000000000000001
1000000000000000000000000000000000000001
1111111111111111111111111111111111111111