111111111111111
100000000000001
10FFFFFFFFFFF01
10F0F1C000000C1
10F00F011110F01
10FP0000EG0CF01
10FFFFFFFFFFF01
100000000000001
111111111111111