11111111111111111111111111111111111111
100000000000000C00000C0000000000000001
10F0000000000000F0F00F0000000000000001
10F000000000000000F0000000000000000001
1P0000000C00C00000000000F0000000C00001
100000000000000C00000C0000000000000001
100000000000000000F0000000000F00000001
100000000000000000000F0000000F0F000001
10000000C00C00000E0000000000000C000001
10000000000F000C00000C0000000000000001
100000000000000000000F000000000F000001
100000000000000000F0000000000000000001
10000000C00C00000000F0000000000C000001
100000000000000C00000F0000000000000001
10000C0000C000000000000000000000000001
10F00000F0C0000000F0000000000F00000001
10000000C00C00000000000000000000000001
11111111111111111111111111111111111111